! Last modified by Alex Smith, 2015-03-10
! Copyright (C) 2014 Alex Smith
! NetHack may be freely redistributed. See license for details.
!
! This text tileset lists tiles that look different in Unicode and in
! ASCII. Note that this file is encoded in UTF-8. You will need a
! UTF-8-aware editor to edit it.
!
! Please restrict these to Unicode characters that exist on Windows
! Glyph List 4. (Windows is the worst out of the major operating
! systems at rendering fonts.) They should also have an exact or close
! approximation on code page 437.
!
! Note: When overriding something to Unicode here, you probably want
! to override it back to ASCII in rogue_overrides.txt.

! Unicodey terrain.
walls 0: gray '│'
walls 1: gray '─'
walls 2: gray '┌'
walls 3: gray '┐'
walls 4: gray '└'
walls 5: gray '┘'
walls 6: gray '┼'
walls 7: gray '┴'
walls 8: gray '┬'
walls 9: gray '┤'
walls 10: gray '├'
doorway: gray '·'
open doors 0: brown '■'
open doors 1: brown '■'
iron bars: cyan '≡'
fountain: blue '⌠'
the floor of a room: bgblack gray regular '·'
sub unlit the floor of a room: bgblack darkgray regular '·'
corridor: bgblack gray regular '░'
sub lit corridor: bgblack white regular '▒'
altar: gray 'Ω'
ice: cyan '·'
lowered drawbridges 0: brown '·'
lowered drawbridges 1: brown '·'
water: blue '≈'
underwater: blue '≈'
lava: red '≈'
tree: green '±'

! Replace the characters in zaps and swallows with Unicode, while
! maintaining color.
zap ? 0: basefg '│'
zap ? 1: basefg '─'
explosion * 1; explosion * 7: basefg '─'
explosion * 3; explosion * 5: basefg '│'

! Swallows.
swallow top center: orange '─'
swallow bottom center: orange '─'
swallow middle left: orange '│'
swallow middle right: orange '│'

! Traps.
web: gray '╬'

! Dragon differentiation: use diacritics to distinguish levels.
baby gray dragon: gray 'D'
young gray dragon: gray 'Ḋ'
gray dragon: gray 'Ď'
elder gray dragon: gray base_underline 'Ď'
ancient gray dragon: gray base_underline 'Ð'

baby silver dragon: bright_cyan 'D'
young silver dragon: bright_cyan 'Ḋ'
silver dragon: bright_cyan 'Ď'
elder silver dragon: bright_cyan base_underline 'Ď'
ancient silver dragon: bright_cyan base_underline 'Ð'

baby red dragon: red 'D'
young red dragon: red 'Ḋ'
red dragon: red 'Ď'
elder red dragon: red base_underline 'Ď'
ancient red dragon: red base_underline 'Ð'

baby white dragon: white 'D'
young white dragon: white 'Ḋ'
white dragon: white 'Ď'
elder white dragon: white base_underline 'Ď'
ancient white dragon: white base_underline 'Ð'

baby orange dragon: orange 'D'
young orange dragon: orange 'Ḋ'
orange dragon: orange 'Ď'
elder orange dragon: orange base_underline 'Ď'
ancient orange dragon: orange base_underline 'Ð'

baby black dragon: darkgray 'D'
young black dragon: darkgray 'Ḋ'
black dragon: darkgray 'Ď'
elder black dragon: darkgray base_underline 'Ď'
ancient black dragon: darkgray base_underline 'Ð'

baby blue dragon: blue 'D'
young blue dragon: blue 'Ḋ'
blue dragon: blue 'Ď'
elder blue dragon: blue base_underline 'Ď'
ancient blue dragon: blue base_underline 'Ð'

baby green dragon: green 'D'
young green dragon: green 'Ḋ'
green dragon: green 'Ď'
elder green dragon: green base_underline 'Ď'
ancient green dragon: green base_underline 'Ð'

baby yellow dragon: yellow 'D'
young yellow dragon: yellow 'Ḋ'
yellow dragon: yellow 'Ď'
elder yellow dragon: yellow base_underline 'Ď'
ancient yellow dragon: yellow base_underline 'Ð'
